NO textures/castle/banner.xpm
SO textures/castle/knight2.xpm
WE textures/castle/windows.xpm
EA textures/castle/walls.xpm

F 99, 99, 99
C 59, 59, 59

        1111111111111111111111111
        100000000000S000000010001
        1000000000000000000010001
        1000000000000000000010001
111111111000000001111111000011011
1000000010000111110000000000000001111111111111
100010001000000001000010000000000D000000000001
1D11111110000000110000100000111111111111111001
100000000000001D100000100000000000000100000001
1111111111111111111111111111111111111100000001
                                   1110000000111111111111111111111111111
                                   1000000000D000000000000000000000000D1
                                   1110000000111111111111111111111111111
                                   11100000001
                                   10000000001
                                   11100000001
11111111111111111                    100000001
11L11111111111111          1111111111111000001
10001  1000000001          10000000000000000001
10001  1000000001111111111111111110000000000001
10001  100000000D0000000000D0010000000000000001
10001  1000000001111111111110010000000011D11001
10001111000000001          10010000000010001001
10000000000000001          10010000000010001001
10000000000000001         110000000000010011001
10000000000000001        1000001111111111100001
10001111000000001       10000001100000000000001
10001  1000000001      100000001100000000000001
10001  1000000001     1000000001111100000000001
10001  1000000001    10000000000000000000000001
111111111100011111  111000000000001111111111111
10000001000001        1000111000000000001      
1000000D000001        10001 1000000000001      
10000001000001        10001 1000000000001      
11111111111111        1111111111111111111      
