NO textures/castle/banner.xpm
SO textures/castle/knight2.xpm
WE textures/castle/windows.xpm
EA textures/castle/walls.xpm

F 99, 99, 99
C 59, 59, 59

1111111111111111111111111
1000000000000000000000001
1000000000000000000000001
1000000000000000000000001
10000000000S0000000000001
1000000000000000000000001
1000000000000000000000001
10000000000L0000000000001
1111111111111111111111111
