NO textures/castle/banner.xpm
SO textures/castle/knight2.xpm
WE textures/castle/windows.xpm
EA textures/castle/walls.xpm

F 99, 99, 99
C 59, 59, 59

                       111111111111111     111111111111111
                       1111111B1111111     1111111D1111111
                       100000000000001     100000000000001
                       100000000000001     100000000000001
                       100000000000001     100000000000001
                       100000000000001     100000000000001
             11111111111111T1111111D1111111111T11111111111
             100000000000000000110000000000000000001
             100000000000000000110000000000000000001
             100000000000000000110000000000000000001
             100000000000000000110000000000000000001
             100000000000000000110000000000000000001
             100000000000000000110000000000000000001
11111111111111111T111111111111111D111111111111111111
10000000000001000000000000000000000001
10000000000001000000000000000000000001
10000000000001000000000000000000000001
10000000000001000000000000000000000001
10000000000001000000000000000000000001
10000000000001000000000000000000000001
11111111T11111111111111D11111111T11111111111
    1000000000000000000000110000000000000001
    1000000000000000000000110000000000000001
    1000000000000000000000110000000000000001
    1000000000000000000000110000000000000001
    1000000000000000000000110000000000000001
    1000000000000000000000110000000000000001
    1000000000000000000000110000000000000001
    1111111111111D11111111111T11111111111111   11111111111111
              10000000000000000000001          10000000000001
              10000000000000000000001          10000000000001
              10000000000000000000001          10000000000001
              10000000000000000000001          10000000000001
              10000000000000000000001          10000000000001
              10000000000000000000001          10000000000001
              1111111111111111111D111111111111111111T11111111
                             100000000000000000000000001
                             100000000000000000000000001
                             100000000000000000000000001
                             100000000000000000000000001
                             100000000000000000000000001
                             100000000000000000000000001
                             111111111111111111111111111
