NO textures/castle/banner.xpm
SO textures/castle/knight2.xpm
WE textures/castle/windows.xpm
EA textures/castle/walls.xpm

F 99, 99, 99
C 59, 59, 59

111111111111111111111111111111111111111111
111L11110000001000000100000100000100000001
100S00010000001000000D00000100000100000001
10000001000000D000000100000100000D00000001
100000010000001000000100000100000100000001
111D111111D111111D111111D11111D111111D1111
100000010000001000000100000100000100000001
1000000D000000D000000D00000D00000D00000001
100000010000001000000100000100000100000001
111D111111D111111D111111D11111D111111D1111
100000010000001000000100000100000100000001
1000000D000000D000000D00000D00000D00000001
100000010000001000000100000100000100000001
111D111111D111111D111111D11111D111111D1111
100000010000001000000100000100000100000001
1000000D000000D000000D00000D00000D00000001
100000010000001000000100000100000100000001
111111111111111111111111111111111111111111
