NO textures/castle/banner.xpm
SO textures/castle/knight2.xpm
WE textures/castle/windows.xpm
EA textures/castle/walls.xpm

F 99, 99, 99
C 59, 59, 59

11111111111111111111111111
10000010000000100000000001
10110010000000D00110011D11
10110010001100100100001001
10000010010000111110001111
10110010100000100000000001
10000011100111100000000001
100000D000000011D111111111
11001110000000100000100001
100000100000001000001000W1
111L1110000000100000D00001
11111111111111111111111111
