NO textures/castle/walls.xpm
SO textures/castle/banner.xpm
WE textures/castle/windows.xpm
EA textures/castle/knight2.xpm

F 99, 99, 99
C 59, 59, 59

111111111111111111111111111111111111
1000D00000000D0000000000000000001001
100111000001111111111111000001000001
100D0100000100000001111100001111111
1001010000011000000001110000D000L01
1111100000000000000000011111111111
    1111100000001001111
        11111D11111
        10000000001
        10000000001
        10000N00001
        11111111111
