NO textures/castle/banner.xpm
SO textures/castle/knight2.xpm
WE textures/castle/windows.xpm
EA textures/castle/walls.xpm

F 99, 99, 99
C 59, 59, 59

111111111111111111111111111111111111
100000000000000000000000000000001001
100111000111100000000111000001000001
100D0100111111000000111110000111111
1001010000111000000001110000D000L1
111110000000000000000001111111111
    1111100000001001111
	11111D11111
	10000N00001
	11111111111
