NO textures/castle/banner.xpm
SO textures/castle/knight2.xpm
WE textures/castle/windows.xpm
EA textures/castle/walls.xpm

F 99, 99, 99
C 59, 59, 59

                                                                             1
                                                                            101
                                                                             1

                                                                           1
                                                                          101
                                                                           1
                                                  1
                                                 101                    1
                                                10001                  101
                                               1000001                  1
                                              100000001
                                             10000000001
                                            1000000000001            1111111
                                           100000000000001           1111L11
                                          10000000000000001          1000001
                                         1000000000000000001         1000001
                                        100000000000000000001        1000001
                                       10000000000000000000001       1000001
                                      1000000000000000000000001      1000001
                                     100000000000000000000000001     1000001
                                    10000000000000000000000000001    1000001
                                   1000000000000000000000000000001   1000001
                                  100000000000000000000000000000001  1000001
                                 10000000000000000000000000000000001 1000001
                                10000000000000000000000000000000000011000001
                               100000000000000000000000000000000000001000001
                              1000000000000000000000000000000000000000000001
                             10000000000000000000000000000000000000000000001
                            100000000000000000000000000000000000000000000001
                           1000000000000000000000000000000000000000000000001
                          10000000000000000000000000000000000000000000000001
                         100000000000000000000000000000000000000000000000001
                        10000000000000000000000000000000000000000000000000001                                                   1
                       1000000000000000000000000000000000000000000000000000001                                                     1
                      100000000000000000000000000000000000000000000000000000001
                     10000000000000000000000000000000000000000000000000000000001
                    1000000000000000000000000000000000000000000000000000000000001                                                          1
                   100000000000000000000000000000000000000000000000000000000000001
                  10000000000000000000000000000000000000000000000000000000000000001
                 1000000000000000000000000000000000000000000000000000000000000000001
                100000000000000000000000000000000000000000000000000000000000000000001
               10000000000000000000000000000000000000000000000000000000000000000000001
              1000000000000000000000000000000000000000000000000000000000000000000000001
             100000000000000000000000000000000000000000000000000000000000000000000000001
            10000000000000000000000000000000000000000000000000000000000000000000000000001
           1000000000000000000000000000000000000000000000000000000000000000000000000000001
          100000000000000000000000000000000000000000000000000000000000000000000000000000001
         10000000000000000000000000000000000000000000000000000000000000000000000000000000001                                                                                 1
        1000000000000000000000000000000000000000000000000000000000000000000000000000000000001
       100000000000000000000000000000000000000000000000000000000000000000000000000000000000001
      10000000000000000000000000000000000000000000000000000000000000000000000000000000000000001
     1000000000000000000000000000000000000000000000000000000000000000000000000000000000000000001
    100000000000000000000000000000000000000000000000000000000000000000000000000000000000000000001
   10000000000000000000000000000000000000000000000000000000000000000000000000000000000000000000001
  1000000000000000000000000000000000000000000000000000000000000000000000000000000000000000000000001
 100000000000000000000000000000000000000000000000000000000000000000000000000000000000000000000000001
10000000000000000000000000000000000000000000000000000000000000000000000000000000000000000000000000001
10000000000000000000000000000000000000000000000000000000000000000000000000000000000000000000000000001
10000000000000000000000000000000000000000000000000000000000000000000000000000000000000000000000000001
10000000000000000000000000000000000000000000000000000000000000000000000000000000000000000000000000001
10000000000000000000000000000000000000000000000000000000000000000000000000000000000000000000000000001
10000000000000000000000000000000000000000000000000000000000000000000000000000000000000000000000000001
10000000000000000000000000000000000000000000000000000000000000000000000000000000000000000000000000001
10000000000000000000000000000000000000000000000000000000000000000000000000000000000000000000000000001
10000000000000000000000000000000000000000000000000000000000000000000000000000000000000000000000000001
10000000000000000000000000000000000000000000000000000000000000000000000000000000000000000000000000001
10000000000000000000000000000000000000000000000000000000000000000000000000000000000000000000000000001
10000000000000000000000000000000000000000000000000000000000000000000000000000000000000000000000000001
10000000000000000000000000000000000000000000000000000000000000000000000000000000000000000000000000001
10000000000000000000000000000000000000000000000000000000000000000000000000000000000000000000000000001
10000000000000000000000000000000000000000000000000000000000000000000000000000000000000000000000000001
10000000000000000000000000000000000000000000000000000000000000000000000000000000000000000000000000001
10000000000000000000000000000000000000000000000000000000000000000000000000000000000000000000000000001
10000000000000000000000000000000000000000000000000000000000000000000000000000000000000000000000000001
10000000000000000000000000000000000000000000000000000000000000000000000000000000000000000000000000001
10000000000000000000000000000000000000000000000000000000000000000000000000000000000000000000000000001
1111111111111111111111111111111111111111111111111111T111111111111111111111111111111111111111111111111
10000000000000000000000000000000000000000010000000000000000010000000000000000000000000000000000000001
100000000000000000000000000000000000000000D0000000000000000010000000000000000000000000000000000000001
10000000000000000000000000000000000000000010000000000000000010000000000000000000000000000000000000001
10000000000000000000000000000000000000000010000000000000000010000000000000000000000000000000000000001
10000000000000000000000000000000000000000010000000000000000010000000000000000000000000000000000000001
1111111111111111111T111110000000000000000010000000000000000010000000000000000000000000000000000000001
10000000000000000000000010000000000000000010000000000000000010000000000000000000000000000000000000001
111111111111D1111111111110000000000000000010000000000000000010000000000000000000000000000000000000001
10000000000000000000000010000000000000000010000000000000000010000000000000000000000000000000000000001
10000000000000000000000010000000000000000010000000000000000010000000000000000000000000000000000000001
10000000000000000000000010000000000000000010000000000000000010000000000000000000000000000000000000001
100000000000000000000000D00000000000000000100000000000000000D0000000000000000000000000000000000000001
10000000000000000000000010000000000000000010000000000000000010000000000000000000000000000000000000001
10000000000000000000000010000000000000000010000000000000000010000000000000000000000000000000000000001
10000000000000000000000010000000000000000010000000000000000010000000000000000000000000000000000000001
100N0000000000000000000010000000000000000010000000000000000010000000000000000000000000000000000000001
11111111111111111111111111111111111111111111111111111111111111111111111111111111111111111111111111111
