NO textures/castle/banner.xpm
SO textures/castle/knight2.xpm
WE textures/castle/windows.xpm
EA textures/castle/walls.xpm

F 99, 99, 99
C 59, 59, 59


                                                  1
                                                 1L1   
                                                10001                 
                                               1000001       
                                              100000001
                                             10000000001
                                            1000000000001            1111111
                                           100000000000001           1111111
                                          10000000000000001          1000001
                                         111T11111111D111111         111T111
                                        100000000000000000001        1000001
                                       10000000000000000000001       111D111
                                      1000000000000000000000001      1000001
                                     100000000000000000000000001     1000001
                                    11111111D111111111T1111111111    111D111
                                   1000000000000000000000000000001   1000001
                                  100000000000000000000000000000001  1000001
                                 10000000000000000000000000000000001 111D111
                                10000000000000000000000000000000000011000001
                               111111111111D111111111111T1111111111111000001
                              1000000000000000000000000000000000000000000001
                             10000000000000000000000000000000000000000000001
                            1000000000000000000011111T1111100000000000000001
                           1000000000000000000001000000000100000000000000001
                          10000000000000000000001000000000100000000000000001
                         100000000000000000000001000000000100000000000000001
                        1111111111111T11111111111000000000111111111D111111111
                       1000000000000000000000000000000000000000000000000000001
                      100000000000000000000000000000000000000000000000000000001
                     10000000000000000000000000000000000000000000000000000000001
                    1000000111111111111111111111111111111111111111111111111111111
                   100000000000000000000000000000000000000000000000000000000000001
                  10000000000000000000000000000000000000000000000000000000000000001
                 1000000000000000000000000000000000000000000000000000000000000000001
                111111111111111111111111111111111111111111111111111111111111100000001
               10000000000000000000000000000000000000000000000000000000000000000000001
              1000000000000000000000000000000000000000000000000000000000000000000000001
             100000000000000000000000000000000000000000000000000000000000000000000000001
            10000011111111111111111111111111111111111111111111111111111111111111111111111
           1000000000000000000000000000000000000000000000000000000000000000000000000000001
          100000000000000000000000000000000000000000000000000000000000000000000000000000001
         10000000000000000000000000000000000000000000000000000000000000000000000000000000001
        1111111111111111111111111111111111111111111111111111111111111111111111111111110000001
       100000000000000000000000000000000000000000000000000000000000000000000000000000000000001
      10000000000000000000000000000000000000000000000000000000000000000000000000000000000000001
     1000000000000000000000000000000000000000000000000000000000000000000000000000000000000000001
    100000111111111111111111111111111111111111111111111111111111111111111111111111111111111111111
   10000000000000000000000000000000000000000000000000000000000000000000000000000000000000000000001
  1000000000000000000000000000000000000000000000000000000000000000000000000000000000000000000000001
 100000000000000000000000000000000000000000000000000000000000000000000000000000000000000000000000001
111111111111111D111111111111111111111111111T111111111111111111111111111111111111111111111111111111111
10000000000000000000000000100000000000000000000000000000000010000000000000000000000000000000000000001
10000000000000000000000000100000000000000000000000000000000010000000000000000000000000000000000000001
100000000000000000000000001000000000000000000000000000000000111111111111111111T1111111111111111111111
10000000000000000000000000D00000000000000000000000000000000010000000000000000000000000000000000000001
100000000000000000000000001000000000000000000000000000000000T0000000000000000000000000000000000000001
10000000000000000000000000100000000000000000000000000000000010000000000000000000000000000000000000001
1000000000000000000000000010000000000000000000011D111111111110000000000000000000000000000000000000001
10000000000000000000000000100000000000000000000100000000000000000000000000000000000000000000000000001
1111111111111111111111111111111111111111111111111111T11111111111111111111111111111D111111111111111111
10000000000000000000000000000000000000000000000000000000000000000000000000000000000000000000000000001
10000000000000111111111111111111111100000000000000000000000000000000000000000000000000000000000000001
10000000000000100000000000000000000100000000000000000000000000000000000000000000000000000000000000001
10000000000000D00000000000000000000100000000000000000000000000000000000000000000000000000000000000001
10000000000000100000000000000000000T00000000000000000000000000000000000000000000000000000000000000001
10000000000000111111111111111111111111111111111111111111111111111111111111111111111111111111111111111
10000000000000000000000000000000000000000000000000000000000000100000000000000000000000000000000000001
10000000000000000000000000000000000000000000000000000000000000100000000000000000000000000000000000001
10000000000000000000000000000000000000000000000000000000000000D00000000000000000000000000000000000001
10000000000000000000000000000000000000000000000000000000000000100000000000000000000000000000000000001
1111111111111111111111111T11111111111111111111111111T11111111111D1111111T1111111111111111111111111111
10000000000000000000000000000000000000000010000000000000000010000000000000000000100000000000000000001
1111111111111111111T111111111111111111111110000000000000000010000000000000000000100000000000000000001
10000000000000000000000000000000000000000010000000000000000010000000000000000000D00000000000000000001
10000000000000000000000000000000000000000010000000000000000010000000000000000000100000000000000000001
10000000000000000000000000000000000000000010000000000000000010000000000000000000100000000000000000001
10000000000000000000000000000000000000000010000000000000000010000000000000000000100000000000000000001
10000000000000000000000000000000000000000010000000000000000010000000000000000000100000000000000000001
111111111111D111111111111111111111111111111111111111D111111111111111111111111111100000000000000000001
10000000000000000000000010000000000000000010000000000000000010000000000000111000000000000000000000001
10000000000000000000000010000000000000000010000000000000000010000000000000T00000000000000000000000001
10000000000000000000000010000000000000000010000000000000000010000000000000100100000000000000000000001
100000000000000000000000D00000000000000000100000000000000000D0000000000001010010000000000000000000001
100000000000000000000000100000000000000000T0000000000000000010000000000110000001000000000000000000001
10000000000000000000000010000000000000000010000000000000000010000000001000000000100000000000000000001
10000000000000000000000010000000000000000010000000000000000010000001110000000000010000000000000000001
100N0000000000000000000010000000000000000010000000000000000010000000D00000000000001000000000000000001
11111111111111111111111111111111D1111111111111111111D111111111111111111111111111111111111111111111111
100000000000000000000000000000000000000000000000000000000000000000000001
111111111111111111111111111111111111111111111111111111111111111111111111
