NO textures/castle/banner.xpm
SO textures/castle/knight2.xpm
WE textures/castle/windows.xpm
EA textures/castle/walls.xpm

F 99, 99, 99
C 59, 59, 59

        1111111111111111111111111
        1000000000110000000000001
        101100111110000011D111D11
  1111  1L1000000D000000100010001
11100111111111D101100000100010001
10000000001100010111D111111111111
1111D111111111011100000010001
1111011111111100D0010100D0001
11000000110101011100000010001
10000000000000001100000010001
100001111000000001101010010001
110E00011101010111110111100111
10000101 1110101 10111100D0001
11111111 1111111 111111111011
                         111
