NO textures/secret/secret.xpm
SO textures/secret/secret.xpm
WE textures/secret/secret.xpm
EA textures/secret/secret.xpm

F 0,0,1
C 0,0,1

1111
10S1
1001
1111
