NO textures/castle/banner.xpm
SO textures/castle/knight2.xpm
WE textures/castle/windows.xpm
EA textures/castle/walls.xpm

F 99, 99, 99
C 59, 59, 59

        1111111111111111111111111
        100000000000S000000010001
        1000000000000000000010001
        1000000000000000000010001
111111111000000001111111000011011
1000000010000000000000000000000001111111111111
1000100010000000000000000000000000000000000001
1D11111110000000000000000000000000000000000001
100000000000001D100000000000000000000000000001
1111111111111111111111111111111111111100000001
                                   1110000000111111111111111111111111111
                                   1000000000D000000000000000000000000D1
                                   1110000000111111111111111111111111111
                                   11100000001
                                   10000000001
                                   11100000001
                                     100000001
11111111111111111          1111111111100000000111111111111111111111111111111111111111111111111111
10000000000000001          1000000000000000000000000000000000000000000000000000000000000000000001
1000000000000000111111111111000000000000000000000000000000000000000000000000000000000000000000001
1000000000000000D0000000000D000000000000000000000000000000000000000000000000000000000000000000001
1000000000000000111111111111000000000000000000000000000000000000000000000000000000000000000000001
10000000000000001          1000000000000000000000000000000000000000000000000000000000000000000001
10000000000000001          1000000000000000000000000000000000000000000000000000000000000000000001
1000000000000000111111111111000000000000000000000000000000000000000000000000000000000000000000001
1000000000000000000000000000000000000000000000000000000000000000000000000000000000000000000000001
1000000000000000000000000000000000000000000000000000000000000000000000000000000000000000000000001
1000000000000000000000000000000000000000000000000000000000000000000000000000000000000000000000001
1000000000000000000000000000000000000000000000000000000000000000000000000000000000000000000000001
1000000000000000000000000000000000000000000000000000000000000000000000000000000000000000000000001
1000000000000111111111100000000000000000111111111100000000000000111111111100000000000000000000001
10000000000001        1000000000000000001        1000000000000001        100000000000000000000001
10000000000001        1000000000000000001        1000000000000001        100000000000000000000001
10000000000001        1000000000000000001        1000000000000001        100000000000000000000001
11111111111111        1111111111111111111        1111111111111111        111111111111111111111111
