NO textures/castle/banner.xpm
SO textures/castle/knight2.xpm
WE textures/castle/windows.xpm
EA textures/castle/walls.xpm

F 99, 99, 99
C 59, 59, 59

  1111111
  111L111
 110000011
10000000001
 110000011
  1000001
 110000011
10000000001
 110000011
  100N001
  1111111
