NO textures/castle/banner.xpm
SO textures/castle/knight2.xpm
WE textures/castle/windows.xpm
EA textures/castle/walls.xpm

F 99, 99, 99
C 59, 59, 59

                                     11111111111111111111111111111111111111                                                                         
                                     10000000000000000000000000000000000011                                                                         
                                     10000000000001111111011111111111111111                                                                         
                                     10000000001111111100011110001111111111                                                                         
                                     10000000111111100000010000001111111111                                                                         
                                     10000111111110000000000000001111111011                                                                         
                                     10011111110000000000000001111111100011                                                                         
                                     10111111000000000000000111111100000011                                                                         
                                     10111100000000000000011111110000000011                                                                         
                                     10111100000000000000011111110000000011                                                                         
                                     10111111111111111111011111110001111111                                                                         
                                     10000000000001111111011111110111111111                                                                         
                                     10000000000001111111000000000000000011                                                                         
                                     10000000000001111111000000000000000011                                                                                                                                                 
1111111111111111111111111111111111111111111111111111111111111111111111111111111111111111111111111111111111111111111111111111111111111111111111111111
1111111111111111111111111111111111111111111111111111111111111111111111111111111111111111111111111111111111111111111111111111111111111111111111111111
1000000000000000000000000000000000001100000000000000000000000000000000000110000000000000000000000000000000000011000000000000000000000000000000000001
1000000000000111111101111111111111111100000000000011111110111111111111111110000000000001111111011111111111111111000000000000111111101111111111111111
1000000000111111110001111000111111111100000000011111111000111100011111111110000000001111111100011110001111111111000000000111111110001111000111111111
1000000011111110000001000000111111111100000001111111000000100000011111111110000000111111100000010000001111111111000000011111110000001000000111111111
1000011111111000000000000000111111101100001111111100000000000000011111110110000111111110000000000000001111111011000011111111000000000000000111111101
1001111111000000000000000111111110001100111111100000000000000011111111000110011111110000000000000001111111100011001111111000000000000000111111110001
1011111100000000000000011111110000001101111110000000000000001111111000000110111111000000000000000111111100000011011111100000000000000011111110000001
1011110000000000000001111111000000001101111000000000000000111111100000000110111100000000000000011111110000000011011110000000000000001111111000000001
1011110000000000000001111111000000001101111000000000000000111111100000000110111100000000000000011111110000000011011110000000000000001111111000000001
1011111111111111111101111111000111111101111111111111111110111111100011111110111111111111111111011111110001111111011111111111111111101111111000111111
1000000000000111111101111111011111111100000000000011111110111111101111111110000000000001111111011111110111111111000000000000111111101111111011111111
1000000000000111111100000000000000001100000000000011111110000000000000000110000000000001111111000000000000000011000000000000111111100000000000000001
1000000000000111111100000000000000001100000000000011111110000000000000000110000000000001111111000000000000000011000000000000111111100000000000000001
1111111111111111111111111111111111111111111111111111111111111111111111111111111111111111111111111111111111111111111111111111111111111111111111111111
1111111111111111111111111111111111111111111111111111111111111111111111111111111111111111111111111111111111111111111111111111111111111111111111111111
100000000000000000000000000000000000110000000000000000000000000000000000011                                                                         
100000000000011111110111111111111111110000000000001111111011111111111111111                                                                         
100000000011111111000111100011111111110000000001111111100011110001111111111                                                                         
100000001111111000000100000011111111110000000111111100000010000001111111111                                                                         
100001111111100000000000000011111110110000111111110000000000000001111111011                                                                         
100111111100000000000000011111111000110011111110000000000000001111111100011                                                                         
101111110000000000000001111111000000110111111000000000000000111111100000011                                                                         
101111000000000000000111111100000000110111100000000000000011111110000000011                                                                         
101111000000000000000111111100000000110111100000000000000011111110000000011                                                                         
101111111111111111110111111100011111110111111111111111111011111110001111111                                                                         
100000000000011111110111111101111111110000000000001111111011111110111111111                                                                         
100000000000011111110000000000000000110000000000001111111000000000000000011                                                                         
100000000000011111110000000000000000110000000000001111111000000000000000011                                                                         
1111111111111111111111111111111111111111111111111111111111111111111111111111111111111111111111111111111111111111111111111111111111111111111111111111
1111111111111111111111111111111111111111111111111111111111111111111111111111111111111111111111111111111111111111111111111111111111111111111111111111
                                                                         110000000000000000000000000000000000011000000000000000000000000000000000001
                                                                         110000000000001111111011111111111111111000000000000111111101111111111111111
                                                                         110000000001111111100011110001111111111000000000111111110001111000111111111
                                                                         110000000111111100000010000001111111111000000011111110000001000000111111111
                                                                         110000111111110000000000000001111111011000011111111000000000000000111111101
                                                                         110011111110000000000000001111111100011001111111000000000000000111111110001
                                                                         110111111000000000000000111111100000011011111100000000000000011111110000001
                                                                         110111100000000000000011111110000000011011110000000000000001111111000000001
                                                                         110111100000000000000011111110000000011011110000000000000001111111000000001
                                                                         110111111111111111111011111110001111111011111111111111111101111111000111111
                                                                         110000000000001111111011111110111111111000000000000111111101111111011111111
                                                                         110000000000001111111000000000000000011000000000000111111100000000000000001
                                                                         110000000000001111111000000000000000011000000000000111111100000000000000001
                                                                         111111111111111111111111111111111111111111111111111111111111111111111111111
1111111111111111111111111111111111111111111111111111111111111111111111111111111111111111111111111111111111111111111111111111111111111111111111111111
100000000000000000000000000000000000110000000000000000000000000000000000011                                                                         
100000000000011111110111111111111111110000000000001111111011111111111111111                                                                         
100000000011111111000111100011111111110000000001111111100011110001111111111                                                                         
100000001111111000000100000011111111110000000111111100000010000001111111111                                                                         
100001111111100000000000000011111110110000111111110000000000000001111111011                                                                         
100111111100000000000000011111111000110011111110000000000000001111111100011                                                                         
101111110000000000000001111111000000110111111000000000000000111111100000011                                                                         
101111000000000000000111111100000000110111100000000000000011111110000000011                                                                         
101111000000000000000111111100000000110111100000000000000011111110000000011                                                                         
101111111111111111110111111100011111110111111111111111111011111110001111111                                                                         
100000000000011111110111111101111111110000000000001111111011111110111111111                                                                         
100000000000011111110000000000000000110000000000001111111000000000000000011                                                                         
100000000000011111110000000000000000110000000000001111111000000000000000011                                                                         
111111111111111111111111111111111111111111111111111111111111111111111111111                                                                         
1111111111111111111111111111111111111111111111111111111111111111111111111111111111111111111111111111111111111111111111111111111111111111111111111111
                                                                         110000000000000000000000000000000000011000000000000000000000000000000000001
                                                                         110000000000001111111011111111111111111000000000000111111101111111111111111
                                                                         110000000001111111100011110001111111111000000000111111110001111000111111111
                                                                         110000000111111100000010000001111111111000000011111110000001000000111111111
                                                                         110000111111110000000000000001111111011000011111111000000000000000111111101
                                                                         110011111110000000000000001111111100011001111111000000000000000111111110001
                                                                         110111111000000000000000111111100000011011111100000000000000011111110000001
                                                                         110111100000000000000011111110000000011011110000000000000001111111000000001
                                                                         110111100000000000000011111110000000011011110000000000000001111111000000001
                                                                         110111111111111111111011111110001111111011111111111111111101111111000111111
                                                                         110000000000001111111011111110111111111000000000000111111101111111011111111
                                                                         110000000000001111111000000000000000011000000000000111111100000000000000001
                                                                         110000000000001111111000000000000000011000000000000111111100000000000000001
                                                                         111111111111111111111111111111111111111111111111111111111111111111111111111
1111111111111111111111111111111111111111111111111111111111111111111111111111111111111111111111111111111111111111111111111111111111111111111111111111
10000000000000000000000000000000000011000000000000000000000000000000000000D0000000000000000000000000000000000011000000000000000000000000000000000001
100000000000011111110111111111111111110000000000001111111T111111111111111110000000000001111111011111111111111111000000000000111111101111111111111111
1000000000111111110001111000111111111100000000011111111000111100011111111110000000001111111100011110001111111111000000000111111110001111000111111111
100000001111111N000001000000111111111100000001111111000000100000011111111110000000111111100000010000001111111111000000011111110000001000000111111111
1000011111111000000000000000111111101100001111111100000000000000011111110110000111111110000000000000001111111011000011111111000000000000000111111101
100111111100000000000000011111111000D000111111100000000000000011111111000110011111110000000000000001111111100011001111111000000000000000111111110001
101111110000000000000001111111000000110111111000000000000000111111100000011011111100000000000000011111110000000T011111100000000000000011111110000001
1011110000000000000001111111000000001101111000000000000000111111100000000110111100000000000000011111110000000011011110000000000000001111111000000001
101111000000000000000111111100000000110111100000000000000011111110000000011011110000000000000001111111000000001101111000000000000000000T000000000001
1011111111111111111101111111000111111101111111111111111110111111100011111110111111111111111111011111110001111111011111111D11111111101111111000111111
100000000000011111110111111101111111110000000000001111111011111110111111111000000000000111111101111111T111111111000000000000111111101111111011111111
10000000000001111111000000000000000011000000000000T000000000000000000000011000000000000D00000D000000000000000011000000000000111111100000000000000001
100000000000011111110000000000000000110000000000001111111000000000000000011000000000000111111100000000000000000D000000000000111111100000000000000001
1111111111111111111111111111111111111111111111111111111111111111111111111111111111111111111111111111111111111111111111111111111111111111111111111111